1111111111111
1000011000001
1000010000001
1010000011111
1010000000001
1010011111111
1000000010001
1000010000141
1111111111111
