1111111111111
1000000000001
1040000000001
1000000000001
1000000000001
1000000000001
1000000000001
1000000000001
1111111111111
