1111111111111
1000410000001
1001110000001
1000000000001
1000000011111
1000000010001
1000100010001
1000100000001
1111111111111
