1111111111111
1000000000041
1000010000001
1010100000001
1010000000001
1100000000001
1001001010101
1000000000001
1111111111111
