1111111111111
1000000000001
1000010000001
1010100200001
1010000000001
1120020020001
1001001010101
1000000000001
1111111111111
