1111111111111
1000000001001
1001000000001
1000100010011
1110120011111
1000000010001
1020000000001
1000002000001
1111111111111
