1111111111111
1002011000001
1000010000001
1010000011111
1010000000021
1010011111111
1000000010001
1000210000101
1111111111111
