1111111111111
1020000000201
1000000000001
1000000000021
1000000000001
1000000000001
1000000000001
1000000000001
1111111111111
