1111111111111
1000000000001
1000000000001
1000000200001
1000000000001
1020000020001
1000000000001
1000000000001
1111111111111
