1111111
1300001
1000001
1000001
1000001
1111111
