1111111
1300021
1000041
1200021
1000001
1111111
