1111111111111
1000000000031
1000000000001
1000000000001
1000000000001
1000000000001
1000000000001
1000000000001
1111111111111
