1111111111111
1000000001001
1001000000001
1000100010311
1110100011111
1000000010001
1000000000001
1000000000001
1111111111111
