1111111111111
1000010000001
1001110000001
1000000000001
1000000011111
1000000013001
1000100010001
1000100000001
1111111111111
