1111111111111
1000011000001
1000010000001
1010000011111
1310000000001
1010011111111
1000000010001
1000010000101
1111111111111
