1111111111111
1000010000001
1000111000001
1000011100001
1001111111001
1000000100001
1000010000001
1000013000001
1111111111111
