1111111
1000001
1000001
1000001
1400001
1111111
