1111111
1000001
1000001
1000001
1000031
1111111
