1111111
1000021
1000001
1200021
1400031
1111111
