1111111111111
1000000000031
1040000000001
1020000000001
1000000000001
1000000000001
1000000002001
1000000000201
1111111111111
