1111111111111
1000000000041
1000000000001
1000000200001
1300000000001
1020020020001
1000000000001
1000000000001
1111111111111
