1111111111111
1000000000001
1000000000001
1000000000301
1000020000001
1000000000401
1020000000001
1000002000001
1111111111111
