1111111111111
1000000001001
1001000000001
1000100010311
1110120011111
1000000010401
1020000000001
1000000020001
1111111111111
