1111111111111
1002000000001
1000000000001
1000000000001
1300000000021
1000000000001
1040000000001
1000200000001
1111111111111
